1 1 1 1 1 1 1 1 1 1 1 1 1 1 1 1 1 1 1
1 0 0 0 0 0 0 0 0 0 0 0 2 0 0 0 0 9 1
1 0 0 0 0 0 0 0 0 0 0 0 2 0 0 0 0 0 1
1 0 0 0 0 0 0 0 0 0 0 0 2 0 0 0 0 0 1
5 3 3 3 3 3 3 3 3 3 3 3 5 3 3 3 3 3 1
6 0 0 0 0 0 0 0 0 0 0 0 2 0 0 0 0 0 1
7 0 0 0 0 0 0 0 0 0 0 0 2 0 0 0 0 0 1
8 0 0 0 0 0 0 0 0 0 0 0 2 0 0 0 0 0 1
1 0 0 0 0 0 0 0 0 0 0 0 2 0 0 4 0 0 1
1 0 0 0 0 9 9 0 0 0 0 0 2 0 0 0 0 0 1
1 0 0 0 0 9 9 0 0 0 0 0 2 0 0 0 0 0 1
1 1 1 1 1 1 1 1 1 1 1 1 1 1 1 1 1 1 1